############################
#                          #
#           A              #
#                          #
#                          #
#                          #
#                          #
#           a              #
#                          #
#                          #
#                          #
#                          #
#                          #
############################
